11111111111111111111
100000000C0000000001
1P0000000C00000000E1
100000000C0000000001
100000000C0000000001
11111111111111111111
