111111111111111111111111
1P0000000000000000000001
1000000000C0000000000011
1000C0000000000000001CE1
111111111111111111111111
