1111111111111111111111111111111111111
1000000000000000000000000000000000001
10000000000000000P0000000000000000001

100000000000000000000000000000000ECE1
1111111111111111111111111111111111111
