1111111111111111111111111111111111111
1000000000000000000000000000000000001
1000000000000000P00000000000000000001
1000000000000000000000000000000000C01
1111111111111111111111111111111111111
