1111111111111111111111111111111111
1100001000000000000000000111111111
1100001P000000000000000000001E0011
1100001000000001000000C00000101111
1100001111111111000000000000000011
1100EC0000000000000000000000010011
1100000000000000000011111111110111
11000000C0000000000000000000000011
11000C0000000000C01111111111111111
1100000000000000000000000000000111
1111111111111111100000000000000001
1111111111111111111111111111111111
